.............................#..........................................
..S...#......................#...........#......................#.......
......#......................#..#.........#......................#......
.............................#..#.......................................
................................#....#..................................
................................#....#..................................
..............#.................#....#..................................
............#...................#....#..................................
..........#.....................#....#..................................
..............#......................#..................................
..............#......#..........#....#..................................
..............#......#..........#....#..................................
####################################################################....
..............#.........................................................
........................................................................
......#......................#..........................................
......#......................#..........................................
.............................#....................#.....................
..................................................#.....................
#.######################################################################
..............#...................................#.....................
............#...................................#.......................
..........#...................................#.........................
..............#...................................#.....................
..............#......#..........#.................#......#.........#....
..............#......#..........#.................#......#....X....#....
..............#......#..........#.................#......#.........#....
..............#...................................#.....................